XXXXXXXXXXXX
X...X..X...X
X......X.X.X
X..X.X.X.X.X
XX.XXX.X...X
X........X.X
XsXX...X..eX
XXXXXXXXXXXX