XXXXXXXXXXXXX
X....X..X..eX
X..X..X.X.XXX
X...X.X.X.X.X
X....XX.X...X
X.XX......X.X
X.s.X...X...X
XXXXXXXXXXXXX