XXXXXXXXXXXX
X.X.X..X...X
X.X....X.X.X
X..X.X.X.X.X
X..XXX.X...X
X........XXX
XsXX...X..eX
XXXXXXXXXXXX