XXXXXXXXXXXX
X.X.X..X...X
X.X....X.X.X
X..X.X.X.X.X
X..XXX.X...X
X........X.X
XsXX...X..eX
XXXXXXXXXXXX