XXXXXXXXXXXXXXXXXXXXXXXXXXXXXXXXXXXXXXXXXXXXXXXXXXXXXXXXXXXXXXXXXXXXXXXXXXXXXXXXXXXXXXXXXXXXXXXXXXXX
XX..X...X.......X.................X.............X...X.......X...........X.....X.....X...X...X.......
X.XXX.XXX.X.XXXXX.X.XXXXXXXXXXXXXXX.XXXXXXXXXXX.X.X.X.XXXXX.X.XXXXX.XXX.XXXXX.X.XXXXX.XXX.XXX.XXXXXX
X...X.....X.X.....X.......X.........X...X.....X...X.....X.X.X.X.....XXX.......X.....X...............
XXX.X.XXXXXXX.X.XXXXX.XXX.X.XXXXXXXXX.XXX.XXX.XXXXXXXXX.X.X.X.X.XXXXXXXXX.X.XXX.X.X.XXXXX.XXXXXXXXX.
X...X.X.......X.....X...X.X...X...........X...X.......X.X...X.X.......X...X.X...X.X.....X.X...X...X.
X.XXX.X.X.XXXXXXXXXXXXX.XXXXX.XXX.XXXXXXXXX.XXX.XXXXX.X.X.XXXXX.XXXXX.XXXXXXX.XXX.XXXXX.X.XXX.X.X.X.
X...X...X.X.....X.....X.........X.....X...X...X...X.X.X.X.....X.....X...........X.X.X...X.....X.X.X.
XXX.X.XXXXX.X.XXX.XXX.XXXXXXXXX.XXXXX.X.X.XXX.X.X.X.X.X.XXXXX.XXXXXXXXXXXXXXXXXXX.X.X.XXXXXXX.X.X.X.
X.X.X...X...X...X...X.....X...X.X...X.X.X...X...X.X...X.X...X.X.......X...X.......X...X.......X.X...
X.X.X.XXX.XXXXX.X.X.XXXXX.X.X.X.X.X.X.X.X.XXXXXXX.XXXXX.X.X.X.X.XXXXX.X.X.X.X.XXXXX.XXX.XXXXX.X.XXXX
X.X.X.X...X...X.X.X.X...X.X.X.X.X.X.X...X.X.....X.....X.X.X.....X.....X.X...X.X.....X.X.X...X.X.X...
X.X.XXX.XXXXX.X.X.X.XXX.X.XXX.X.X.X.XXX.XXX.XXX.XXX.X.X.XXXXXXXXX.XXXXXXXXXXX.X.XXXXX.X.X.X.XXX.X.X.
X...X...X.....X.X.X.X...X.X...X.X.X.....X...X.......X.X.X...X...X...X...X.....X...X.....X.X.....X.X.
XXX.X.XXX.XXXXX.XXX.X.XXX.X.XXX.X.XXXXX.X.XXXXX.XXXXXXX.X.X.XXX.XXX.X.X.X.XXXXXXX.XXXXXXX.XXXXXXX.X.
X...X.X.X.....X.....X...X.X...X.X.XXX...X.....X...X...X...X...X.X...X.X...X.....X.........X.......X.
X.XXX.X.X.XXX.XXXXXXX.X.X.XXX.X.X.XXX.XXXXXXX.XXX.X.X.XXXXXXX.X.XXX.X.XXXXX.XXX.XXXXXXXXXXX.XXXXXXX.
X.....X.....X.......X.X...X...X.X.X...X...X...X...X.X.........X.....X.X...X...X.......X...X...X.....
XXXXXXX.XXXXXXXXX.XXX.XXXXX.X.X.XXX.XXX.X.X.X.XXX.X.XXXXXXXXXXXXX.XXX.X.X.XXX.XXXXXXX.X.X.XXX.X.XXX.
X.....X...X.......X...X.....X.X.X...X.X.X.X.X...X.X.............X.X.X...X...X.X...X...X.X.....X.X...
X.XXXXXXX.X.XXXXXXX.XXX.X.XXXXX.X.XXX.X.X.XXXXX.XXXXXXXXXXXXXXX.X.X.XXXXXXX.X.X.XXX.XXX.XXXXXXX.X.XX
X.......X.X...........X.X.....X.X.X...X.X.....X...............X.X.....X.....X.X...X.....X.......X...
XXXXX.XXX.XXXXXXXXXXX.X.XXXXX.X.X.X.X.X.XXX.XXXXX.XXXXX.XXXXXXX.XXXXX.X.XXXXX.XXX.XXXXX.X.XXXXXXXXX.
X.X.....X.X.........X.X...X.X...X.X.X.X...X...X...X.....X.....X...X...X...X...X...X...X.X.X.........
X.X.XXX.X.XXX.XXXXX.XXXXX.X.XXXXX.X.XXXXX.XXX.X.XXXXXXXXX.XXX.XXX.XXX.XXX.X.XXX.X.XXX.X.X.XXXXXXX.XX
X...X...X...X.X.........X.X...X...X.....X...X...X...X...X.X.X.X.....X...X.......X.....X.X.......X...
X.XXX.X.XXX.X.XXXXXXXXX.X.XXX.X.XXXXXXX.XXX.XXXXX.X.XXX.X.X.X.X.XXX.XXX.XXXXXXXXX.XXXXXXXXX.X.X.XXX.
X.X...X...X.X.....X...X.X...X.X...........X.....X.X.X.....X.X.X...X.X.........X...X.......X.X.X...X.
X.X.XXXXXXX.XXXXX.X.X.X.XXX.X.XXXXXXX.XXXXXXX.X.X.X.X.XXXXX.X.XXX.X.XXXXXXXXX.XXXXX.XXXXX.X.XXXXX.X.
X.X.......X.......X.X...X.X.X.......X...X.....X.X.X...X.....X.X...X...X.....X.....X.X.....X.X.....X.
XXXXXXX.X.XXXXXXXXX.XXXXX.X.X.XXX.XXXXX.X.XXXXXXX.XXXXX.X.XXX.X.XXXXX.X.XXXXXXXXX.X.XXX.XXX.X.XXXXX.
X.......X.X.......X...X...X.X...X.......X.X.....X.X...X.X.X...X.X...X.X.X.....X.X...X...X...X...X...
X.XXXXXXX.X.XXX.XXXXX.X.X.X.XXXXXXXXXXXXX.X.XXX.X.XXX.X.X.X.XXXXX.X.X.X.X.XXX.X.XXXXX.XXX.XXXXX.X.XX
X.X.....X...X.X...X...X.X.X.......X.....X...X...X...X.X.X...X.X...X...X...X.X.......X...X...X...X.X.
X.X.X.X.XXXXX.XXX.X.XXXXX.XXXXXXX.X.XXX.XXXXX.XXXXX.X.X.XXXXX.X.XXXXXXX.XXX.XXXXXXX.XXX.XXX.X.XXX.X.
X.X.X.X.X.......X...X.......X.....X...X.......X.....X.X.........X.....X.X.X...X.X.....X.X.X.X.X...X.
X.XXX.X.X.XXXXX.XXXXX.X.XXX.X.XXXXXXX.XXXXXXXXX.XXXXX.XXXXXXXXX.X.XXXXX.X.X.X.X.X.XXXXX.X.X.X.XXX.X.
X.X...X.X.X...X.......X.X...X...X.......X.......X.....X...X...X.X.......X...X...X...X...X...X...X.X.
X.X.XXXXX.X.X.XXXXXXXXXXX.XXXXX.X.XXXXX.X.XXXXX.X.XXXXXXX.X.X.X.XXXXX.XXXXX.XXXXX.X.X.XXXXXXX.X.X.X.
X.X.X.....X.X...X.......X...X...X...X...X.X...X.X...........X.X.X...X.X.....X.....X.X.X.....X.X.X...
X.X.X.X.XXXXXXX.X.XXXXX.XXX.X.XXXXX.XXX.X.X.XXX.X.XXXXXXXXXXX.X.X.X.X.X.XXXXX.XXXXXXX.X.XXX.X.X.XXXX
X.X...X.........X.X...X...X.X.....X...X.X.X.X...X...X.......X.X...X.X.X.....X...X.....X.X...X.X.....
X.XXXXXXXXXXXXXXX.X.XXXXX.X.XXXXX.XXX.X.X.X.X.XXXXXXX.XXXXX.X.XXXXX.X.XXX.X.X.X.X.XXXXX.XXX.X.XXXXX.
X.X.....X.........X.......X.X...X...X.X.X.X...X.......X...X.X.......X...X.X.X.X.X.X.....X...X.....X.
X.X.XXX.X.XXXXXXXXX.XXXXXXX.X.X.XXX.X.X.X.XXXXX.XXXXXXX.X.X.XXXXXXXXXXX.X.X.X.X.X.X.XXXXX.XXXXXXXXX.
X.X.X.X.X.....X...............X...X...X.X.......X...X...X.X...........X...X.X.X...X...X...X.........
X.X.X.X.XXXXX.X.XXXXXXXXXXXXXXXXX.XXXXX.XXXXXXXXXXX.X.XXX.XXXXXXXXX.XXXXXXXXX.XXXXXXX.X.XXXXX.X.XXXX
X...X.X...X...X.X.....X.......X.X.X...X.X.........X.X.X...X...X...X.........X.X.......X.X...X.X.X...
XXXXX.XXX.X.XXXXX.XXX.X.XXXXX.X.X.X.X.X.X.XXXXXXX.X.XXX.XXX.XXX.X.XXXXXXX.X.X.X.XXXXXXX.X.X.XXX.X.X.
X.....X...X.......X.X.X...X.X.....X.X...X.X.....X.X.X...X.X.....X.X.X...X.X.X...X.....X...X...X...X.
X.X.XXX.XXX.XXXXXXX.X.XXX.X.X.XXXXX.XXXXX.X.XXX.X.X.X.X.X.X.XXXXX.X.X.X.X.X.XXXXX.XXX.XXXXXXX.XXXXX.
X.X...X.X.X.....X...X.X.X...X...X.X...X...X...X...X...X.X.....X.....X.X.X.X...X...X.X.X.......X...X.
X.XXX.X.X.XXXXX.X.XXX.X.X.XXXXX.X.XXX.X.X.XXXXX.XXXXX.X.X.XXXXX.XXXXX.X.XXXXX.X.XXX.X.X.XXXXXXX.X.X.
X.X.X.X.X.....X.X...X.X...X...X...X.X.X.X.X...X.X...X.X.X.X.X...X...X.X.X...X.X.X...X...X.......X.X.
X.X.X.X.XXXXX.X.XXX.X.XXXXX.X.XXXXX.X.X.XXX.X.X.X.X.X.XXX.X.X.XXX.X.X.X.X.X.X.X.X.X.XXXXX.XXXXXXX.X.
X.X.X.X...X.X...X...X.......X...X...X.X...X.X.X...X...X...X.X.X...X.X.X.X.X...X.X.X...X.X.X...X...X.
X.X.X.XXX.X.X.X.X.XXXXXXXXXXXXX.X.X.X.XXX.X.X.XXXXXXXXX.XXX.X.X.X.X.X.X.X.XXXXX.X.X.X.X.X.X.X.X.XXX.
X...X...X.X.X.X.X.....X.......X...X.....X...X.X.........X...X.X.X.X.X.X...X...X.X.X.X.X.X...X.X...X.
XXXXXXX.X.X.X.X.XXX.XXX.XXXXX.XXXXXXXXX.X.XXX.X.XXXXXXXXX.X.X.X.XXX.X.XXX.X.X.X.XXX.X.X.X.XXX.XXX.X.
X.......X.X...X.....X...X...X.....X...X.X.X...X...........X.X...X...X...X.X.X.X...X.X...X.X...X.X...
X.XXXXXXX.XXXXXXXXXXX.XXX.X.XXXXX.X.XXX.X.X.XXXXXXX.XXXXXXXXXXXXX.XXXXX.X.X.XXXXX.X.XXX.X.X.XXX.X.XX
X.X.....X.....X.....X.X...X.X.X...X.X...X.X.......X.X...........X.X.....X.X.X...X.X.X.X.X.X...X.X...
X.X.XXX.XXXXX.X.XXX.X.X.XXX.X.X.XXX.X.XXX.X.XXXXX.X.X.XXXXXXXXX.X.X.XXXXX.X.X.X.X.X.X.X.X.XXX.X.XXX.
X.X.X...X...X...X.X.X.X.X.....X.X.....X...X.....X.X.X...X.....X...X.X...X.X...X.X.X.X...X...X.X.....
X.X.X.XXXXX.XXXXX.X.X.X.XXXXXXX.XXX.XXXXXXXXXXX.XXX.X.X.XXXXX.XXXXX.X.X.XXXXX.X.X.X.XXXXXXX.X.X.XXXX
X.X.X.....X.......X...X...X...X...X...........X.....X.X.X.......X.X.X.X.X...X.X...X.........X.X.....
X.X.XXXXX.XXXXXXX.XXXXXXX.X.X.XXX.XXXXXXXXXXX.XXXXXXX.X.X.XXXXX.X.X.X.X.X.X.X.XXXXXXXXXXXXX.X.XXXXX.
X.....X.X...X...X.......X.X.X...X.....X.....X.......X.X.X.X.X.....X...X...X.X.X.X.........X.X...X.X.
X.XXX.X.XXX.X.X.XXXXXXX.X.X.XXX.XXXXX.X.XXXXXXXXXXX.X.X.X.X.X.XXX.XXXXXXX.X.X.X.X.XXXXX.X.XXXXX.X.X.
XeX...X.X...X.X.........X.X.X...X.....X.......X.....X.X.X.X.X...X.X.....X.X.X.X...X.....X.X.....X...
XXX.XXX.X.XXX.XXXXXXXXX.X.X.X.XXX.XXXXXXX.X.XXX.XXXXX.X.X.X.XXX.X.X.XXX.X.X.X.XXXXX.XXXXX.X.XXXXXXX.
X...X.X.....X.X...X.....X...X...X...X.....X...X...X...X...X.X...X.X.X...X.X.X.......X...X...X.....X.
X.XXX.X.XXX.X.X.XXX.XXXXXXXXXXX.XXX.XXXXXXXXX.XXX.XXX.XXX.X.X.X.XXX.X.XXXXX.XXXXXXXXX.X.XXXXX.XXX.X.
Xs..X.X...X...X...X...X...........X.....X.....X.X.X...X...X...X.X...X.......X.........X.....X...X.X.
XXX.X.X.XXXXXXXXX.XXX.X.XXXXXXXXX.XXXXX.X.XXXXX.X.X.XXXXXXXXXXX.X.XXX.XXXXXXX.XXXXXXXXXXX.XXX.X.XXX.
X...X...X.....X.....X.......X.......X...X.........X.X.X...X.....X...X.X.....X...X.........X...X.X...
X.XXX.XXX.XXX.X.X.XXX.XXXXXXX.XXXXXXX.XXXXXXXXXXX.X.X.X.X.X.XXXXXXX.XXX.XXX.X.X.X.XXXXXXXXX.XXX.X.XX
X.X...X...X.X.X.X.....X.....X...X.....X.X.......X...X.X.X.X.X...X.......X...X.X.X.X...X.....X.X.X.X.
X.X.XXX.XXX.X.X.XXXXXXX.XXX.XXX.X.XXXXX.X.XXXXX.XXXXX.X.X.X.X.X.X.XXXXXXX.XXX.X.X.XXX.X.XXXXX.X.X.X.
X.X...X.X...X.X...X.X...X...X...X.X.......X...X.....X...X...X.X.X.X.....X.X...X.X...X.X...X...X...X.
X.XXXXX.X.XXX.XXX.X.X.XXX.XXXXXXX.X.XXXXXXX.XXXXXXX.X.XXXXXXXXX.X.XXX.X.X.X.XXXXXXX.X.X.XXX.X.XXXXX.
X.X.......X...X...X.X.X.X.......X.X...X.X.........X.X.....X.X...X.....X.X.X.X...X.....X.X...X.......
X.X.XXXXXXX.XXXXX.X.X.X.XXXXXXX.X.XXX.X.X.XXXXXXX.X.XXXXX.X.X.XXXXXXX.X.X.X.X.X.XXXXX.X.X.X.XXXXXXXX
X.X...X.....X...X...X...X.....X...X.X.X.......X...X.X.....X.X.X...X...X.X.X...X...X...X...X.X.....X.
X.XXX.X.XXXXX.X.XXXXXXX.X.XXXXXXXXX.X.XXXXXXX.X.XXX.X.XXXXX.X.X.X.XXXXXXX.XXXXXXX.XXXXXXXXX.X.XXX.X.
X.....X.......X.X.......X...X.............X...X.X...X.X.....X.X.X.........X.X.....X...X.....X.X...X.
XXX.XXX.XXXXXXX.X.XXXXXXXXX.X.XXXXXXXXXXX.XXXXX.X.XXX.X.XXX.X.X.XXXXXXXXXXX.X.XXX.X.X.X.XXXXX.XXX.X.
X.X.X.X...X.....X.X.....X...X.X.....X...X...X...X.....X.X.....X.X.....X.....X...X.X.X.X.X.......X.X.
X.X.X.XXXXX.XXXXX.X.XXX.X.XXX.X.XXX.X.XXXXX.X.XXXXX.XXX.XXXXXXX.X.XXX.X.XXXXXXX.X.X.X.X.X.XXXXX.X.X.
X.....X.....X.....X...X.X.X...X.X.X.X.....X.X.X...X.....X.....X.X...X.X.X...X...X...X.X.X.....X.X...
X.XXXXX.XXX.X.XXXXXXX.X.X.X.XXX.X.X.XXXXX.X.X.X.X.XXXXX.X.XXX.X.X.XXX.X.X.X.X.XXXXXXX.X.XXXXXXX.XXXX
X.X...X.X...X.....X...X.X...X...X.X.X...X.....X.X.X.....X...X.X...X...X...X.....X...X...X.....X.XXXX
X.X.X.X.XXXXXXXXX.X.XXXXXXXXX.X.X.X.X.X.XXXXXXX.X.XXXXXXXXX.X.XXXXX.XXXXXXXXXXX.X.X.XXXXX.XXX.X.XXXX
X.X.X.X...........X.X...X.....X.X...X.X.......X.X.....X.....X.....X.....X...X.X.X.X.......X...X.XXXX
X.XXX.XXXXXXXXXXXXX.X.X.X.XXXXXXX.XXX.XXXXXXX.X.XXXXX.X.XXXXXXXXX.X.XXX.X.X.X.X.XXXXX.X.XXX.XXX.XXXX
X...X.............X...X.X.X.....X.X...X.....X...X...X...X.X.....X.X...X...X.X.......X.X...X.X...XXXX
XXX.XXXXX.XXX.XXXXX.XXX.X.XXXXX.X.X.XXXXX.X.XXX.XXX.XXX.X.X.XXX.X.XXXXX.XXX.X.XXXXX.XXXXX.X.X.X.XXXX
X.X.....X...X.......X...X.....X...X.....X.X...X.X.....X.X.X.X.X...X...X...X.X.X...X.....X.X.X.X.XXXX
X.XXXXX.XXXXXXXXXXXXX.X.XXXXX.X.XXXXXXX.X.XXX.X.X.XXXXX.X.X.X.XXXXX.X.XXXXX.X.X.XXXXX.X.X.X.XXX.XXXX
X.....................X.......X.........X...X...X.......X...........X.......X.X.......X...X.....XXXX
