XXXXXXXXXXXXXXXXXXXXXXXXXXXXXX
XXX.......X...X...X...X.......
X.X.XXXXX.X.XXX.X.XXX.X.XXX.XX
X...X...X.X.X...X...X...X.X...
XXXXX.XXX.X.X.XXXXX.X.XXX.XXX.
X.X.....X.X.X.X.X...X...X...X.
X.X.XXX.X.X.X.X.X.XXXXX.XXX.X.
X...X...X.X.X.X.X.....X...X.X.
X.X.XXXXX.X.X.X.XXX.X.X.X.X.X.
X.X.....X.X.X.X...X.X...X...X.
X.XXXXX.X.X.X.XXX.XXXXXXXXXXX.
X.X.....X.X.....X.X...........
X.XXXXX.X.XXXXX.X.X.X.XXXXXXX.
X.X.....X...X...X.X.X.X...X...
XXX.XXXXXXX.X.XXX.X.XXX.X.X.XX
X...X...X.X.X.....X...X.X.X.X.
X.X.X.X.X.X.XXXXXXXXX.XXX.X.X.
X.X...X...X.....X.....X...X...
X.XXXXXXX.XXXXX.X.XXXXX.XXXXX.
X.X.....X.X.....X.X.....X.....
X.X.XXX.XXX.XXXXX.XXX.X.X.XXXX
X.X.XeX.....X...X...X.X.X.X...
X.X.X.XXXXXXX.X.XXX.X.X.X.XXX.
X.X.X...X.X...X.X...X.X.X.....
X.X.XXX.X.X.XXX.X.XXX.XXX.XXXX
Xs....X.X.....X.....X...X.....
XXXXX.X.X.XXXXX.XXX.XXX.XXXXX.
X...X...X.X...X...X...X.X.....
X.X.XXX.XXX.X.XXXXXXX.X.X.XXXX
X.X.........X.........X.......
