XXXXXXXXXXXX
XXXXX.XXXXXX
XXXX.s.XXXXX
XXXXX.XXXXXX
XXXXX.XXXXXX
XXXXXeXXXXXX
XXXXXXXXXXXX
XXXXXXXXXXXX