XXXXXXXXXXXX
X...X..X..eX
X.X....X.XXX
X..X.X.X.X.X
XX.....X...X
X.......X.XX
Xs.....X...X
XXXXXXXXXXXX