eX...X.............X
.X.X.X.XXXXXXXXXXX.X
.X.X.X.....X.X...X.X
.X.X.XXXXX.X.X.X.X.X
...X...X...X...X.X.X
XXXXXX.XXX.X.XXX.X.X
.....X...X.X.X...X.X
.XXX.XXX.X.X.X.XXX.X
.X...X...X...X...X.X
.X.X.X.XXX.XXXXXXX.X
.X.X.X.X...X.......X
.X.X.X.XXX.X.XXXXX.X
.X.X.X...X.X.....X.X
.X.XXXXX.X.X.XXX.X.X
.X...X...X.X...X.X.X
.XXX.X.XXX.XXX.XXX.X
...X...X.....X.X...X
XX.XXXXXXXXXXX.X.XXX
...............X..sX
XXXXXXXXXXXXXXXXXXXX
